10
20
D################EEE
D1111111E1111111111#
#1111111E1111111111E
D11**111E1111D11G11E
D111111111111D11111E
D11111111W11*D11111E
D11DDD1111111D11111E
D11G1D1111111D11111E
D1111D1111111D11111E
DDDEDEDDDEDDEDEDDDEE