10
20
D################EEE
D1111111E1111K11111#
#1111111E11K1111111E
D11**111E1111D11G11E
D11111I1111KKD11111E
D11111I11W11*D11111E
D11DDD1I11111D11111E
D11G1D1I11111D11111E
D1111D1111111D11111E
DDDEDEDDDEDDEDEDDDEE