10
20
D################EEE
D1111111E1111111111#
#1111111E11*1111111E
D11**111E11*1D11G11E
D111111*111*1D11111E
D11111111W11*D11111E
D11DDD1**11*1D11111E
D11G1D1111*11D11111E
D1111D1111111D11111E
DDDEDEDDDEDDEDEDDDEE