20
13
####GT#*KK###
#*******KKKK#
#*EEEE**EEEK#
#*E*******EKK
**E*DDDD**EKK
**E*D********
****D*####***
****DI#**K***
II***I#*EEEE*
II****#*E****
II****E*E*DDD
II****E*E*DII
****D*E***DII
****D*EEEED**
**E*D********
**E*DDDD*****
#*E**********
#*EEEEII*****
#******I*****
####**II****S