10
20
D################EEE
D1111111E1IIIIIKKKK#
#1111111E1I1111111KE
D11**111E1I11D1111KE
D111111111111D1111KE
D11111111W11*D1111KE
D1111D1111111D1111KE
D1111D1111111D1111KE
D1111D1111111D11KKKE
DDDEDEDDDEDDEDEDDDEE