20
16
# # # # # # # # # # # # # # # #
# 1 1 1 1 1 1 1 1 1 1 1 1 1 W 1 
# 1 1 1 1 1 1 1 1 1 1 1 1 1 1 1 
# 1 1 1 1 1 1 1 1 1 1 1 1 1 1 1
# 1 1 1 1 1 1 1 1 1 1 1 1 1 1 1 
# 1 1 1 1 1 1 1 1 1 1 1 1 1 1 1
# 1 1 1 1 1 1 1 1 1 1 1 1 1 1 1 
# 1 D D D 1 # # # 1 # # # 1 # #
# 1 D D D 1 # # # 1 # # # 1 # #
# 1 D D D 1 # # # 1 # # # 1 # # 
# 1 1 1 1 1 1 1 1 1 * * * * * * 
# 1 # # # 1 # # # 1 # # # 1 # # 
# 1 # # # 1 # # # 1 # # # 1 # # 
# 1 # # # 1 # # # 1 # # # 1 # #
# 1 1 1 1 1 1 1 1 1 1 1 1 1 1 1 
# 1 # # # 1 # # # 1 # # # 1 # # 
# 1 # # # 1 # # # 1 # # # 1 # # 
# 1 # # # 1 # # # 1 # # # 1 # # 
# 1 1 1 1 1 1 1 1 1 1 1 1 1 1 1 
# 1 # # # 1 # # # 1 # # # 1 # # 
# 1 # # # 1 # # # 1 # # # 1 # # 